WWWWCWWWWWWWWWW
WWOOOWWWWOOOWWW
WWOOOOOOOOOOWWW
WOOOOOOOOOWWWWW
WOOOOOOOOOWWWWW
WWOOOOOOOOOOWWW
WWOOWWOOWWOOWWW
WWOOWWOOWOOOWWW
WWOOOOOOOOOWWWW
WWWWWWWWWWWWWWW
