WWWWWWWCWWWWWWW
WWOOOWWOWOOOWWW
WWWWOOOOOOOOWWW
WOOOOOOOOOWOWWW
WOOOOOOOOOWOWWW
WWOOOOOOOOOOWWW
WWWWWWOOWWOOWWW
WWOOOOOOWOOOWWW
WWWWOOOOOOOWWWW
WWWWWWWWWWWWWWW
