WWOOOWWWWW
WWEOOWWWWW
WWOOOOOOOW
WOOHOOEOWW
WOOOOOOOOW
WWOEOOOOWW
WWOOWWHOWW
WWOOWWOOWW
WWOOIOOOWW
WWWWOOWWWW