WWWWCWWWWWWWWWW
WWOOOWWWWOOOWWW
WWOOOOOOOOOOWWW
WOOHOOOOOOWWWWW
WOOOOOOOOOWWWWW
WWOOOOOOOOOOWWW
WWOOWWHOWWOOWWW
WWOOWWOOWOOOWWW
WWOOIOOOOOOWWWW
WWWWWWWWWWWWWWW
