WWWWCWWWWWWWWWW
WWEOOWWWWOOOWWW
WWOOOOOOOOOOWWW
WOOHOOEOOOWWWWW
WOOOOOOOOOWWWWW
WWOEOOOOOOOOWWW
WWOOWWHOWWOOWWW
WWOOWWOOWOOOWWW
WWOOIOOOOOOWWWW
WWWWWWWWWWWWWWW