WWOOOWWWWWWWWWW
WWEOOWWWWOOOWWW
WWOOOOOOOOOOWWW
WOOHOOEOOOWWWWW
WOOOOOOOOOWWWWW
WWOEOOOOOOOOWWW
WWOOWWHOWWOOWWW
WWOOWWOOWOOOWWW
WWOOIOOOWOOOWWW
WWWWOOOOOOOWWWW