WWWWWWWWWWCWWWW
WWOOOOOOOOOOWWW
WWOOWWWWOOOOWWW
WWWOOOOOOOWWWWW
WOOOWOOOOOWWWWW
WWOOWWOOOOOOWWW
WWOOWWOOWWWOWWW
WWOOWWOOWWWOWWW
WWOOOOOOOOOWWWW
WWWWWWWWWWWWWWW
